11111111111111111111111111111111
1P000100C01000000000000000000001
10000100001000000000000000000001
10000111000000000000000000000111
10000100000000001000000000000001
10001100000000001000000000000001
10000111000000000000000000000111
10000100000000001000000000C00001
10001100000000001000000000000001
10000000000000000000000000000001
100000000000000000000Z0000000001
1000000Z000000000000000000000001
10000Z000000000000000Z0000000001
10000000000000000000000000000001
10000000000000000Z00000000000001
11111111111100000000000000111111
11111111100000000000011111111111
10000111000000000000000000000111
10000100000000001000000000000001
10001100000000001000000000000001
10000000000000000000000000C00001
100000C0000000000000000000000001
10000000000Z00000000000000000001
11111111100000000000011111111111
11111100000000001111111111100001
10000000000000000000000000000001
100000Z0000000000000000000000001
100000000000000C0000000000000001
1000011100000000000000Z000000111
1000010000000000100000E000000001
10001100000000001000000000000001
11111111111111111111111111111111