111111111
100000001
100000001
100000001
100000001
100000001
100000001
1P00000E1
111111111