1111111111111111111111111111111
10P000000100000000000C000000001
100000000100000000000Z00000E001
1000000000000000C00000000111111
1000000000000000000000000000001
1000000000000000000Z0000000Z001
1000000C0000000C000000000000001
1111111111111111111111111111111
