1111111111111111111111111111111111
1P01000001000001000001000001000001
1001001001001001001001001001001001
10000010000010000010000010000010E1
1111111111111111111111111111111111