1111111111
1P000010C1
10000C1001
1000000001
100000Z001
1Z000000E1
1111111111