1111111111111111111111111111111111111111111111111
1P000000E1000000000001000000000000000000001000001
1001111111111001111001111001111001111001111111001
1000001000000001000000001000001001000001000000Z01
1111001001001111111001111111111111111001001111001
1000000001000001000001000001000001000000001000001
1001001111111111111001001111001001111111111001111
1001000001001000000000001001001000000000001001001
1001111111001111001001001001111111111001001001001
1001000000000001001001001000001001000001001000001
1001111111001111111001001001111001111111001C01001
1000000000000000001001000000000001001000001001001
1001111111001111111111111111001111001111001001111
10010Z0000001001000001000001000001000000001000001
11111110011110011110010011111110010011110Z1001001
1000000000001001000001000000000001001000001001001
1111111001111001001001111001001111001001111111001
1000000001001000001000001001001001001001000001001
1111111111001111111001001001111001111001111001001
1000001000000000000001000001000001001000000000001
1111001001001001111001111001001001001111111111001
1000001001001001001000001000001000000001001000001
1001111111001001001111111111001111111111001001111
1000Z000010C1001000001001001001000000001001001001
1001111111001111001111001001111001111111001001001
1000000000000000001001000000000000000000000000001
10C1001001111111111001001111001001111111111111111
1001001000000000000001001000001001000000001000001
1111111001111111111001111111001001001001111111001
1000000001001000000001000000001000001000000001001
1001111001001111001001001111001111111111111111001
1001000000001000001000001000000000000000000000001
1111111111111111111111111111111111111111111111111
